#include <iostream>
#include <cstdlib>
#include <conio.h>
#include <time.h>
#include <windows.h>
using namespace std;

int main()
{
int mapcounter= 0;
int i,j;
int map1[20][10]={ 1,1,1,1,1,1,1,1,1,1,1,1,1,1,1,1,1,1,1,1,
                   1,0,0,0,0,0,0,0,0,1,1,0,0,0,0,0,0,0,0,1,
                   1,1,1,0,1,1,1,1,0,1,1,0,1,1,1,1,2,1,1,1,
                   1,0,0,0,0,0,0,0,0,1,1,0,0,0,0,0,0,0,0,1,
                   1,0,1,0,1,1,1,1,0,0,0,0,1,1,1,1,0,1,0,1,
                   1,0,1,0,1,1,1,1,0,0,0,0,1,1,1,1,0,1,0,1,
                   1,0,0,0,0,0,0,0,0,1,1,0,0,0,0,0,0,0,0,1,
                   1,1,1,0,1,1,1,1,0,1,1,0,1,1,1,1,0,1,1,1,
                   1,0,0,0,0,0,0,0,0,1,1,0,0,0,0,0,0,0,0,1,
                   1,1,1,1,1,1,1,1,1,1,1,1,1,1,1,1,1,1,1,1
                   };

for( i= 0;i<20;i++)
{
for( j= 0;j<10;j++)
{

if(mapcounter==20)
{
   cout<<""<<endl;
        mapcounter=0;
}
if(map1[i][j]==1)
{
cout<<"X";
} 
  else if(map1[i][j]==0)
{
       cout<<" ";
}

      mapcounter++;
}
}
}
